0 0 0 0 3 0 0 0 0 0 0 3 0 0 0 0
0 0 0 0 3 0 0 0 0 0 0 3 0 0 0 0
0 0 0 0 3 0 0 0 0 0 0 3 0 0 0 0
0 0 0 0 3 0 0 0 0 0 0 3 0 0 0 0
0 0 0 0 3 0 0 0 0 0 0 3 0 0 0 0
0 0 0 0 3 0 0 0 0 0 0 3 0 0 0 0
0 0 0 0 3 0 0 0 0 0 0 3 0 0 0 0
0 0 0 0 3 0 0 0 0 0 0 3 0 0 0 0
0 0 0 0 3 0 0 0 0 0 0 3 0 0 0 0
2 2 0 0 3 0 0 0 0 0 0 3 0 0 2 2
2 2 4 4 3 4 4 4 4 4 4 3 4 4 2 2
1 1 1 1 1 1 1 1 1 1 1 1 1 1 1 1